# # # # # # # # # # # # # # # # # # # #
#           #                         #
#   #   # # #   # # #   #   # # # # # #
#   #   #               #             #
#   #   #       #       #   # # #   # #
#             S #                   # #
#       # # # # #   # # # # #   # # # #
#       #                   #         #
#   # # # # #   # # #   # # #       # #
#   #       #   #       #   #       # #
#   #   #   #   #   #   #   # # #   # #
#   #   #           #             G   #
#   #   #       #   #   #   # # #   # #
#               #   #   #           # #
#   #       #   #   #   #   # # #   # #
#   #       #   #       #       #     #
#   #   #   #   #   #   #       #   # #
#   #   #           #           #   # #
#   #   #   #   # # #   # # # # #   # #
# # # # # # # # # # # # # # # # # # # #
